               wwwwwwww
               w      w
wwwwwwwwwwwwwwww      wwwwwwwwwwwwwwwwwww
w                     w                 w
w                  s  w          e      w
w     wwwwwwwwwwwwwwwww      w      wwwww
w     w            w         w          w
w     w   e        w         w          w
w     wwwwwww      w     wwwwwwwwww     w
w     w                  w        w     w
w     w                  w s      w     w
w     w    wwwwwwwwwwwwwwwwww     w     w
w          w                      w     w
w   e      w                      w     w
w wwwwwwwwww      wwwwwwwwwwwwwwwww     w
w                                       w
w s                                   s w
wwwwwwwwwwwwwwwww      wwwwwwwwwwwwwwwwww
                w   p   w                 
                wwwwwwww